11111111111111111111
10000000010002000001
10888888000002000001
10888888000000000001
12888888000000011111
10888888222222000001
10888888220000002201
10888888220000222201
10000080000000022201
10000202000220888201
12222202220220888881
10222002200200888881
10000000002200888881
12000100022000888881
12200100000022288881
12220100000000888881
12220100000000888801
12222000222000220001
11222000262000220001
11111111111111111111
